WWWWWWWWWWWWWWWWW
WFFFFFFFFFFFFFFFW
WFFFFFFFFFFFFFFFW
WFFFFFFFPFFFFFFFW
WFFFFFFFFFFFFFFFW
WFFFFFFFFFFFFFFFW
WFFFFFFFFFFFFFFFD
WFFFFFFFFFFFFFFFD
WFFFFFFFFFFFFFFFD
WFFFFFFFFFFFFFFFD
WFFFFFFFFFFFFFFFD
WFFFFFFFFFFFFFFFW
WFFFFFFFFFFFFFFFW
WFFFFFFFFFFFFFFFW
WFFFFFFFFFFFFFFFW
WFFFFFFFFFFFFFFFW
WWWWWWWWWWWWWWWWW