WWWWWWWWWWWWWWWWW
WFFFFFFFFFFFFFFFW
WFFFFFFFFFFFFFFFW
WFFFFFFFFFFFFFFFW
WFFFFFFFFFFFFFFFW
WFFFFFFFFFFFFFFFW
DFFFFFFFFFFFFFFFD
DFFFFFFFFFFFFFFFD
DFFFFFFFFFFFFFFFD
DFFFFFFFFFFFFFFFD
DFFFFFFFFFFFFFFFD
WFFFFFFFFFFFFFFFW
WFFFFFFFFFFFFFFFW
WFFFFFFFFFFFFFFFW
WFFFFFFFFFFFFFFFW
WFFFFFFFFFFFFFFFW
WWWWWWWWWWWWWWWWW