WWWWWWWWWWWWWWWWWWWWWWW
WFFFFFFFFFFFFFFFFFFFFFW
WFFFFFFFFFFFFFFFFFFFFFW
WFFFFFFFFFFFFFFFFFFFFFW
WFFFWWWFFFFFFFFFWWWFFFW
WFFFWFFFFFFFFFFFFFWFFFW
WFFFWFFFFFFFFFFFFFWFFFW
WFFFFFFFFFFFFFFFFFFFFFW
WFFFFFFFFFFFFFFFFFFFFFW
DFFFFFFFFFFFFFFFFFFFFFW
DFFFFFFFFFFFFFFFFFFFFFW
DFFFFFFFFFFFFFFFFFFFFFW
DFFFFFFFFFFFFFFFFFFFFFW
DFFFFFFFFFFFFFFFFFFFFFW
WFFFFFFFFFFFFFFFFFFFFFW
WFFFFFFFFFFFFFFFFFFFFFW
WFFFWFFFFFFFFFFFFFWFFFW
WFFFWFFFFFFFFFFFFFWFFFW
WFFFWWWFFFFFFFFFWWWFFFW
WFFFFFFFFFFFFFFFFFFFFFW
WFFFFFFFFFFFFFFFFFFFFFW
WFFFFFFFFFFFFFFFFFFFFFW
WWWWWWWWWWWWWWWWWWWWWWW