WWWWWWWWWWWWWWWWW
WFFFFWFFFFFFFFFFW
WFFFFWFFFFFPFFFFW
WFFPFWFFFFFFFFFFW
WFFFFWFFFFFWFFFFW
WFFFFWFFFFFWFFFFW
DFFFFWFFFFFWFFFFD
DFFFFWFFFFFWFFFFD
DFFFFWFFFFFWFFFFD
DFFFFWFFFFFWFFFFD
DFFFFWFFFFFWFFFFD
WFFFFWFFFFFWFFFFW
WFFFFWFFFFFWFFFFW
WFFFFFFFFFFWFFPFW
WFFFFPFFFFFWFFFFW
WFFFFFFFFFFWFFFFW
WWWWWWWWWWWWWWWWW