WWWWWWWWWWWWWWWWW
WFFFFFFFFFFFFFFFW
WFFFFFFFFFFFFFFFW
WFFFFFFFFFFFFFFFW
WFFFFFFFFFFFFFFFW
WFFFFFFFFFFFFFFFW
DFFFFFFFFFFFFFFFW
DFFFFFFFFFFFFFFFW
DFFFFFFFFFFFFFFFW
DFFFFFFFFFFFFFFFW
DFFFFFFFFFFFFFFFW
WFFFFFFFFFFFFFFFW
WFFFFFFFFFFFFFFFW
WFFFFFFFFFFFFFFFW
WFFFFFFFFFFFFFFFW
WFFFFFFFFFFFFFFFW
WWWWWWWWWWWWWWWWW