WWWWWWWWWWWWWWWWW
WFFFFWFFFFFFFFFFW
WFFFFWFFFFFFFFFFW
WFFFFWFFFFFFFFFFW
WFFFFWFFFFFWFFFFW
WFFFFWFFFFFWFFFFW
DFFFFWFFFFFWFFFFD
DFFFFWFFFFFWFFFFD
DFFFFWFFFFFWFFFFD
DFFFFWFFFFFWFFFFD
DFFFFWFFFFFWFFFFD
WFFFFWFFFFFWFFFFW
WFFFFWFFFFFWFFFFW
WFFFFFFFFFFWFFFFW
WFFFFFFFFFFWFFFFW
WFFFFFFFFFFWFFFFW
WWWWWWWWWWWWWWWWW