WWWWWWWWWWWWWWWWW
WFFFFFFFFFFFWFFFW
WFFWWWWWWFFFWFFFW
WFFFFFFFWFFFWFFFW
WFFFFFFFWFFFWFFFW
WWWWWFFFWFFFWFFFW
DFFFWFFFWFFFWFFFD
DFFFWFFFWFFFWFFFD
DFFFWFFFWFFFWFFFD
DFFFWFFFWFFFWFFFD
DFFFWFFFWFFFWFFFD
WFFFWFFFWFFFWFFFW
WFFFWFFFWFFFWFFFW
WFFFFFFFWFFFWFFFW
WFFFFFFFWFFFFFFFW
WFFFFFFFWFFFFFFFW
WWWWWWWWWWWWWWWWW