WWWWWWWWWWWWWWWWW
WFFFFFFFFFFFWFFFW
WFFWWWWWWFPFWFPFW
WFFFFFFFWFFFWFFFW
WFFFFFPFWFFFWFFFW
WWWWWFFFWFFFWFFFW
DFFFWFFFWFFFWFFFD
DFFFWFFFWFFFWFFFD
DFFFWFFFWFFFWFFFD
DFFFWFPFWFFFWFFFD
DFFFWFFFWFFFWFFFD
WFFFWFFFWFFFWFFFW
WFFFWFFFWFPFWFFFW
WFFFFFFFWFFFWFFFW
WFFFPFFFWFFFFFPFW
WFFFFFFFWFFFFFFFW
WWWWWWWWWWWWWWWWW